Sunrise
An Interactive Fiction by AshTomWin
Release 1 / Serial number 130314 / Inform 7 build 6G60 (I6/v6.32 lib 6/12N) SD

Room 3539
You can see Door 3539 and Savva here.

>s
(first opening Door 3539)

Hallway 1
There are graffiti on the walls and dust everywhere. A mouse can be heard rustling in a corner.

You can see a Stairwell Door and Door 3539 here.

>w
(first opening the Stairwell Door)

Stairwell Room
You can see a Stairwell Door here.

>e
Hallway 1

>s
Room 3540

>n
Hallway 1

>w
Stairwell Room

>w
You can't go that way.

>s
You can't go that way.

>e
Hallway 1

>e
Hallway 2

>e
Hallway 3

>e
Hallway 4

>e
Hallway 5

>e
You can't go that way.

>w
Hallway 4

>s
Room 3544

>n
Hallway 4

>n
Room 3545 <Your Room>

>s
Hallway 4

>l
Hallway 4

>look
Hallway 4

>look around
You can't see any such thing.

>e
Hallway 5

>n
Room 3547

>s
Hallway 5

>s
Room 3546

>n
Hallway 5

>w
Hallway 4

>w
Hallway 3

>n
Room 3543

>s
Hallway 3

>s
Hall Bathroom

>s
You can't go that way.

>n
Hallway 3

>w
Hallway 2

>n
Room 3541

>s
Hallway 2

>s
Room 3542

>n
Hallway 2

>w
Hallway 1

>n
Room 3539

>s
Hallway 1

>s
Room 3540

>s
You can't go that way.

>n
Hallway 1

>n
Room 3539

>w
Bathroom of 3539

>w
You can't go that way.

>e
Room 3539

* * *

>w
(first opening the Stairwell Door)

Stairwell Room
You can see a Stairwell Door here.

>s
You can't go that way.

>e
Hallway 1
You can see a Stairwell Door and Door 3539 here.

* * *

>s
(first opening Door 3539)

Hallway 1
There are graffiti on the walls and dust everywhere. A mouse can be heard rustling in a corner.

You can see a Stairwell Door and Door 3539 here.

>e
Hallway 2
There are graffiti on the walls and dust everywhere. The light on the ceiling is flickering. The bulb should be replaced soon.

>e
Hallway 3
There are graffiti on the walls and dust everywhere. It is very quiet in the middle of the hallway; you can hear the echoes of sounds from inside the residents" rooms.

>e
Hallway 4
There are graffiti on the walls and dust everywhere. The light on the ceiling is completely dead. It needs to be replaced soon.

>e
Hallway 5
It is very dark, and the window is too dirty to show you what is going on outside at this time of night. The graffiti art on the wall seems to represent the devil, with the number 666 painted on both sides. Who lives at this end of the hallway?

>s
Room 3546
The smell is rife with marijuana. The window is wide open, and the heater is turned on all the way. Gentle yet hypnotic music is playing in the background. The color theme of the room is rainbow. There are clothes scattered about the room, but there is a diary on the desk.

>n
Hallway 5
It is very dark, and the window is too dirty to show you what is going on outside at this time of night. The graffiti art on the wall seems to represent the devil, with the number 666 painted on both sides. Who lives at this end of the hallway?

>w
Hallway 4
There are graffiti on the walls and dust everywhere. The light on the ceiling is completely dead. It needs to be replaced soon.

>w
Hallway 3
There are graffiti on the walls and dust everywhere. It is very quiet in the middle of the hallway; you can hear the echoes of sounds from inside the residents" rooms.

>s
Hall Bathroom
There is a public bathroom in the middle of the hall. The bathroom is very dirty. The bathroom has not been cleaned in several years. The mirror in the bathroom wall is hanging on one edge. The sink is dirty but not clogged. There is no soap to be found in the bathroom. The shower can only fit one person at a time. There are blood stains on the shower floor. The shower head is broken. When the water is turned on for the shower, it sprays water like that of a lawn hose. The toilet is clogged. There is poop in the toliet that seems to not have been flushed in years. It smells terrible. There is a sink, toilet, shower and a mirror in the bathroom.

* * *

>s
(first opening Door 3539)

Hallway 1
There are graffiti on the walls and dust everywhere. A mouse can be heard rustling in a corner.

You can see a Stairwell Door and Door 3539 here.

>s
Room 3540
Cold and dark. You feel a sudden rush of cold breeze brush against you as you turn your attention to the wide open window across the dark room. There is a small bed beneath the window with worn out blankets. The floor is dusty with cobwebs occupating the corners of the room. A rocking chair rocks slightly, making a creaking noise. It seems like it has been vacant for a while.

You can see Zoya here.

>ask about my leg
You can't see any such thing.

>ask about taft
You can't see any such thing.

>ask zoya about targdrhg
There is no reply.

>ask zoya about ivana
I dont know what you're talking about

>ask me about ivana
I dont know what you're talking about

>ask siurhgsriuhgsriug about ivana
You can't see any such thing.

* * *

>s
Room 3540
Cold and dark. You feel a sudden rush of cold breeze brush against you as you turn your attention to the wide open window across the dark room. There is a small bed beneath the window with worn out blankets. The floor is dusty with cobwebs occupating the corners of the room. A rocking chair rocks slightly, making a creaking noise. It seems like it has been vacant for a while.

You can see Zoya here.

>ask zoya about gate combination
Unfortunately I don't know what the gate combination is. I think the man who used to live next door to me

* * *

>s
Room 3540
Cold and dark. You feel a sudden rush of cold breeze brush against you as you turn your attention to the wide open window across the dark room. There is a small bed beneath the window with worn out blankets. The floor is dusty with cobwebs occupating the corners of the room. A rocking chair rocks slightly, making a creaking noise. It seems like it has been vacant for a while.

You can see Zoya here.

>ask zoya about soeubg
There is no reply.

>ask zoya about gate combination
Unfortunately I don't know what the gate combination is. I think the man who used to live next door to me had an idea who did, but he wasn't exactly the most straight headed person. Not sure what happened to him..

* * *

>s
Room 3540
Cold and dark. You feel a sudden rush of cold breeze brush against you as you turn your attention to the wide open window across the dark room. There is a small bed beneath the window with worn out blankets. The floor is dusty with cobwebs occupating the corners of the room. A rocking chair rocks slightly, making a creaking noise. It seems like it has been vacant for a while.

You can see Zoya here.

>ask zoya about the gate combination
Unfortunately I don't know what the gate combination is. I think the man who lives in 3542 (next door) to me had an idea who did, but he wasn't exactly the most level headed person. Not sure who he is though..

>n
Hallway 1
There are graffiti on the walls and dust everywhere. A mouse can be heard rustling in a corner.

You can see a Stairwell Door and Door 3539 here.

>e
Hallway 2
There are graffiti on the walls and dust everywhere. The light on the ceiling is flickering. The bulb should be replaced soon.

* * *

>e
Hallway 5
It is very dark, and the window is too dirty to show you what is going on outside at this time of night. The graffiti art on the wall seems to represent the devil, with the number 666 painted on both sides. Who lives at this end of the hallway?

>s
Room 3546
The smell is rife with marijuana. The window is wide open, and the heater is turned on all the way. Gentle yet hypnotic music is playing in the background. The color theme of the room is rainbow. There are clothes scattered about the room, but there is a diary on the desk.

You can see Masha here.

>n
Hallway 5
It is very dark, and the window is too dirty to show you what is going on outside at this time of night. The graffiti art on the wall seems to represent the devil, with the number 666 painted on both sides. Who lives at this end of the hallway?

I beg your pardon?

>n
Room 3547
There are bottles of liquor everywhere -- vodka, whiskey, rum -- grouped up in a minibar located at the corner of the room. The window is cracked open slightly, and the bed is plagued with stained drinks and the carpet with vomit. There is a torn luggage with some items.

You can see Petya here.

>ask petya about the gate combination
There is no reply.

>ask petya about the man who lives in 3542
Ah. I believe his name was Jakov. He used to live here a while ago, I don't really remember what happened to him.

>n
You can't go that way.

>look
Room 3547
There are bottles of liquor everywhere -- vodka, whiskey, rum -- grouped up in a minibar located at the corner of the room. The window is cracked open slightly, and the bed is plagued with stained drinks and the carpet with vomit. There is a torn luggage with some items.

You can see Petya here.

>s
Hallway 5
It is very dark, and the window is too dirty to show you what is going on outside at this time of night. The graffiti art on the wall seems to represent the devil, with the number 666 painted on both sides. Who lives at this end of the hallway?

>w
Hallway 4
There are graffiti on the walls and dust everywhere. The light on the ceiling is completely dead. It needs to be replaced soon.

* * *

>w
Hallway 3
There are graffiti on the walls and dust everywhere. It is very quiet in the middle of the hallway; you can hear the echoes of sounds from inside the residents" rooms.

>w
Hallway 2
There are graffiti on the walls and dust everywhere. The light on the ceiling is flickering. The bulb should be replaced soon.

>w
Hallway 1
There are graffiti on the walls and dust everywhere. A mouse can be heard rustling in a corner.

You can see a Stairwell Door and Door 3539 here.

>n
Room 3539
You can see Door 3539 and Savva here.

Savva stares at you creepily

>s
Hallway 1
There are graffiti on the walls and dust everywhere. A mouse can be heard rustling in a corner.

You can see Door 3539 and a Stairwell Door here.

>knock
That's not a verb I recognise.

* * *

>s
(first opening Door 3539)

Hallway 1
There are graffiti on the walls and dust everywhere. A mouse can be heard rustling in a corner.

You can see a Stairwell Door and Door 3539 here.

I beg your pardon?

I beg your pardon?

>s
Room 3540
Cold and dark. You feel a sudden rush of cold breeze brush against you as you turn your attention to the wide open window across the dark room. There is a small bed beneath the window with worn out blankets. The floor is dusty with cobwebs occupating the corners of the room. A rocking chair rocks slightly, making a creaking noise. It seems like it has been vacant for a while.

You can see Zoya here.

>ask zoya about the gate combination
There is no reply.

>ask zoya about gate combination
I dont know what you're talking about

* * *

Sunrise
An Interactive Fiction by AshTomWin
Release 1 / Serial number 130314 / Inform 7 build 6G60 (I6/v6.32 lib 6/12N) SD

Room 3539
You can see Door 3539 and Savva here.

>look
Room 3539
You can see Savva here.

Savva stares at you creepily

>talk
That's not a verb I recognise.

>talk to
That's not a verb I recognise.

* * *

Sunrise
An Interactive Fiction by AshTomWin
Release 1 / Serial number 130314 / Inform 7 build 6G60 (I6/v6.32 lib 6/12N) SD

Room 3539
You can see Door 3539 and Savva here.

>talk to savva
That's not a verb I recognise.