Sunrise
An Interactive Fiction by AshTomWin
Release 1 / Serial number 130315 / Inform 7 build 6G60 (I6/v6.32 lib 6/12N) SD

Room 3545
It is a spartan room. There is a wire frame bed with a mattress on it and a closet. There is a dresser with two drawers in it. The wallpaper in the room is peeling off.

>s
Hallway 4
There are graffiti on the walls and dust everywhere. The light on the ceiling is completely dead. It needs to be replaced soon.

>w
(first opening the Stairwell Door)

Stairwell Room
You can see a Stairwell Door here.

* * *

>s
Hallway 4
There are graffiti on the walls and dust everywhere. The light on the ceiling is completely dead. It needs to be replaced soon.

>e
Hallway 2
There are graffiti on the walls and dust everywhere. The light on the ceiling is flickering. The bulb should be replaced soon.

* * *

>e
Hallway 4
There are graffiti on the walls and dust everywhere. The light on the ceiling is completely dead. It needs to be replaced soon.

>e
Hallway 5
It is very dark, and the window is too dirty to show you what is going on outside at this time of night. The graffiti art on the wall seems to represent the devil, with the number 666 painted on both sides.  
 
A large window on the wall leads outside.

>s
Room 3546
The smell is rife with marijuana. The window is wide open, and the heater is turned on all the way. Gentle yet hypnotic music is playing in the background. The color theme of the room is rainbow. There are clothes scattered about the room, but there is a diary on the desk.

* * *

>e
Hallway 5
It is very dark, and the window is too dirty to show you what is going on outside at this time of night. The graffiti art on the wall seems to represent the devil, with the number 666 painted on both sides.  
 
A large window on the wall leads outside.

>x window
You look outside. There are no buildings around, just an empty field. The apartment is on the 3rd floor, but the ground is concrete. Jumping looks like it may kill you.

>jump out window
I only understood you as far as wanting to jump.

>jump
You jump on the spot, fruitlessly.

>jump window
I only understood you as far as wanting to jump.

* * *

>e
Hallway 5
It is very dark, and the window is too dirty to show you what is going on outside at this time of night. The graffiti art on the wall seems to represent the devil, with the number 666 painted on both sides.  
 
A large window on the wall leads outside.

>jump out window
You jump to your death

* * *

>e
Hallway 3
There are graffiti on the walls and dust everywhere. It is very quiet in the middle of the hallway; you can hear the echoes of sounds from inside the residents" rooms.

>s
Hall Bathroom
There is a public bathroom in the middle of the hall. The bathroom is very dirty. The bathroom has not been cleaned in several years. The mirror in the bathroom wall is hanging on one edge. The sink is dirty but not clogged. There is no soap to be found in the bathroom. The shower can only fit one person at a time. There are blood stains on the shower floor. The shower head is broken. When the water is turned on for the shower, it sprays water like that of a lawn hose.

You can see Toilet here.

>tank toilet tank
That's not a verb I recognise.

>take toilet tank
You can't see any such thing.

* * *

>s
Hall Bathroom
There is a public bathroom in the middle of the hall. The bathroom is very dirty. The bathroom has not been cleaned in several years. The mirror in the bathroom wall is hanging on one edge. The sink is dirty but not clogged. There is no soap to be found in the bathroom. The shower can only fit one person at a time. There are blood stains on the shower floor. The shower head is broken. When the water is turned on for the shower, it sprays water like that of a lawn hose.

You can see Toilet here.

>take toilet tank
Taken.

>open toilet tnak
I only understood you as far as wanting to open Toilet tank.

>open tank
That's not something you can open.

* * *

>s
Hall Bathroom
There is a public bathroom in the middle of the hall. The bathroom is very dirty. The bathroom has not been cleaned in several years. The mirror in the bathroom wall is hanging on one edge. The sink is dirty but not clogged. There is no soap to be found in the bathroom. The shower can only fit one person at a time. There are blood stains on the shower floor. The shower head is broken. When the water is turned on for the shower, it sprays water like that of a lawn hose.

You can see Toilet here.

>take key
You can't see any such thing.

>x toilet
(Toilet)
The toilet is clogged. The water is dirty and seems to not have been flushed in years. The toilet tank has a lid that's scratched all over the sides. It looks like it has been opened frequently.

>open tank
That's not something you can open.

* * *

>s
Hall Bathroom
There is a public bathroom in the middle of the hall. The bathroom is very dirty. The bathroom has not been cleaned in several years. The mirror in the bathroom wall is hanging on one edge. The sink is dirty but not clogged. There is no soap to be found in the bathroom. The shower can only fit one person at a time. There are blood stains on the shower floor. The shower head is broken. When the water is turned on for the shower, it sprays water like that of a lawn hose.

You can see Toilet here.

>x toilet
(Toilet)
The toilet is clogged. The water is dirty and seems to not have been flushed in years. The toilet tank's lid is loose and doesnt seem to close properly.

>x toilet tnak
You can't see any such thing.

>x toilet tank
In Toilet tank is Key 3540.

* * *

>x toilet
(Toilet)
The toilet is clogged. The water is dirty and seems to not have been flushed in years. The toilet tank's lid is loose and doesnt seem to close properly.

>x toilet tank
You see nothing special about Toilet tank.

>open toilet tank
That's not something you can open.

* * *

>s
Hall Bathroom
There is a public bathroom in the middle of the hall. The bathroom is very dirty. The bathroom has not been cleaned in several years. The mirror in the bathroom wall is hanging on one edge. The sink is dirty but not clogged. There is no soap to be found in the bathroom. The shower can only fit one person at a time. There are blood stains on the shower floor. The shower head is broken. When the water is turned on for the shower, it sprays water like that of a lawn hose.

You can see Toilet here.

>open tank
You open Toilet tank, revealing Key 3542.

>take key
Taken.

>n
Hallway 3
There are graffiti on the walls and dust everywhere. It is very quiet in the middle of the hallway; you can hear the echoes of sounds from inside the residents" rooms.

>e
Hallway 4
There are graffiti on the walls and dust everywhere. The light on the ceiling is completely dead. It needs to be replaced soon.

>w
Hallway 3
There are graffiti on the walls and dust everywhere. It is very quiet in the middle of the hallway; you can hear the echoes of sounds from inside the residents" rooms.

* * *

>w
Hallway 2
There are graffiti on the walls and dust everywhere. The light on the ceiling is flickering. The bulb should be replaced soon.

>open door
It seems to be locked.

>unlock door
(with Key 3542)
You unlock Door 3542.

>s
(first opening Door 3542)

Room 3542
The window is closed shut, and it is very warm in here. The heater is on. There is a vintage strongbox by the head of the bed, and it looks like it needs a key to open it.

>look
Room 3542
The window is closed shut, and it is very warm in here. The heater is on. There is a vintage strongbox by the head of the bed, and it looks like it needs a key to open it.

>n
Hallway 2
There are graffiti on the walls and dust everywhere. The light on the ceiling is flickering. The bulb should be replaced soon.

>n
Room 3541
The room has its walls painted all white. The furniture and other objects contain no vibrant color--they reflect the colors of a zebra. The window is only a crack open. It is warm in here, and the tall lamp at the corner of the room brightens the room up pretty damn well. There is a TV playing in the background.

You can see Stas here.

>talk to stas
That's not a verb I recognise.

* * *

>e
Hallway 2
There are graffiti on the walls and dust everywhere. The light on the ceiling is flickering. The bulb should be replaced soon.

>s
(first opening Door 3542)
It seems to be locked.

>e
Hallway 3
There are graffiti on the walls and dust everywhere. It is very quiet in the middle of the hallway; you can hear the echoes of sounds from inside the residents" rooms.

* * *

>s
Hall Bathroom
There is a public bathroom in the middle of the hall. The bathroom is very dirty. The bathroom has not been cleaned in several years. The mirror in the bathroom wall is hanging on one edge. The sink is dirty but not clogged. There is no soap to be found in the bathroom. The shower can only fit one person at a time. There are blood stains on the shower floor. The shower head is broken. When the water is turned on for the shower, it sprays water like that of a lawn hose.

You can see Toilet here.

>take key
Taken.

I beg your pardon?

>n
Hallway 3
There are graffiti on the walls and dust everywhere. It is very quiet in the middle of the hallway; you can hear the echoes of sounds from inside the residents" rooms.

>w
Hallway 2
There are graffiti on the walls and dust everywhere. The light on the ceiling is flickering. The bulb should be replaced soon.

You can see Door 3542 here.

>s
(first opening Door 3542)
It seems to be locked.

* * *

Sunrise
An Interactive Fiction by AshTomWin
Release 1 / Serial number 130315 / Inform 7 build 6G60 (I6/v6.32 lib 6/12N) SD

Room 3545
It is a spartan room. There is a wire frame bed with a mattress on it and a closet. There is a dresser with two drawers in it. The wallpaper in the room is peeling off.

>talk to savva
What do you want?